#################
#e..#.....#.....#
###.#.##.##.##..#
##....#.......###
####.##.##.##.###
##......#.....###
######.###.######
####.....#.######
####.##.##.######
####..........###
#########.###x###
#################