###############
#e..#.#...#..##
###.#.##.##.###
##....#..#...x#
####.##.##.####
##...........##
######.###.####
##...........##
###############