########
#e######
#.....##
##.#.###
##.#####
#...#.x#
###...##
########