#################
#e..#.....#.....#
###.#.##.##.##.x#
##....#.......###
####.##.##.##.###
##......#.....###
######.###.######
##...........####
#################