#####################
#e..#.....#.....#...#
###.#.##.##.##..#..##
##....#...........###
####.##.##.##.###..##
##......#......#...x#
######.###.#######..#
##...........#####..#
#####################